1111111111111111111
1000000001000000001
1011011101011101101
1000000000000000001
1011010111110101101
1000010001000100001
1111011101011101111
0001010000000101000
1111010110110101111
0000000100010000000
1111010111110101111
0001010000000101000
1111010111110101111
1000000001000000001
1011011101011101101
1000100000000010001
1110101011101010111
1000001001001000001
1011111101011111101
1000000000000000001
1111111111111111111

111111111111111111110000000010000000011011011101011101101100000000000000000110110101111101011011000010001000100001111101110101110111100010100000001010001111010110110101111000000010001000000011110101111101011110001010000000101000111101011111010111110000000010000000011011011101011101101100010000000001000111101010111010101111000001001001000001101111110101111110110000000000000000011111111111111111111