1111111111111111111
1000000001000000001
1011011101011101101
1000000000000000001
1011010111110101101
1000010001000100001
1111011101011101111
0001010000000101000
1111010110110101111
0000000100010000000
1111010111110101111
0001010000000101000
1111010111110101111
1000000001000000001
1011111101011111101
1000100000000010001
1110101011101010111
1000001001001000001
1011111101011111101
1000000000000000001
1111111111111111111

111111111111111111114444444414444444411411411141411141141144444444444444444114114141111141411411444414441444144441111141114141114111100014100000001410001111410110110141111000040010001004000011114101111101411110001410000000141000111141411111414111114444444414444444411411411141411141141144414444444441444111141414111414141111444441441441444441141111114141111114114444444444444444411111111111111111111