810000000000000000000000002000004000000000000000000000000000000000000000000000000000000000000000000000000000000000000000000000000000000000000000000000000000000000000000000000000000000000000000000000000000000000000000000000000000000000000000000000000000000000000000000000000000000000000000000000000000000000000000000000000000000000000000000000000000000000000000000000000000000000000000000000000000009
801200000000000000000000000000004000000000000000000000000000000000000000000000000000000000000000000000000000000000000000000000000000000000000000000000000000000000000000000000000000000000000000000000000000000000000000000000000000000000000000000000000000000000000000000000000000000000000000000000000000000000000000000000000000000000000000000000000000000000000000000000000000000000000000000000000000009
800123000000000000000000000000004000000000000000000000000000000000000000000000000000000000000000000000000030000000000000000000000000000000000000000000000000000000000000000000000000000000000000000000000000000000000000000000000000000000000000000000000000000000000000000000000000000000000000000000000000000000000000000000000000000000000000000000000000000000000000000000000000000000000000000000000000009
800010200400401000005000000000004000000000000000000000000000000000000000000000000000000000000000000000000333300000000000000000000000000000000000000000000000000000000000000000000000000000000000000000000000000000000000000000000000000000000000000000000000000000000000000000000000000000000000000000000000000000000000000000000000000000000000000000000000000000000000000000000000000000000000000000000000009
811203344550000000000000000000004000000000000000000000000000000000000000000000000000000000000000000000000000000000000000000000000000000000000000000000000000000000000000000000000000000000000000000000000000000000000000000000000000000000000000000000000000000000000000000000000000000000000000000000000000000000000000000000000000000000000000000000000000000000000000000000000000000000000000000000000000009
111111111111111111110000002000004000011000000000000000001100000000000000000110000003000000000011000000000000000001100000000000000000110000000000000000011000000000000000001100000000000000000110000000000000000011000000000000000001100000000000000000110000000000000000011000000000000000001100000000000000000110000000000000000011000000000000000001100000000000000000110000000000000000011111111111111111111
111111111111111111110000002000004000011000000000000000001100000000000000000110000003000000000011000000000000000001100005000100000000110000000000000000011000000000000000001100000000000000000110000000000000000011000010000000000001100000000000000000110000000000010000011000000000000000001100001000000000000110000000000000000011000000000000000001100000000000000000110000033333333370011111111111111111111
111111111111111111110000000010004000011011011101011101101100000000000000000110110101111101011011000010001000100001111101110101110111100010100030001010001111010110110101111000000013331000000011110101111101011110001010000000101000111101011111010111110000000010000000011011111101011111101100010000200001000111101010111010101111000001001001000001101111110101111110110000000000000000011111111111111111111
111111111111111111114444444414444444411511411141411141151144444444444444444114114141111141411411444414441444144441111141110101114111100014100030001410001111410116110141111000040013731004000011114101111101411110001410000000141000111141011111414111114444444414444444411411111141411111141154414444244441445111141414111414141111444441441441444441141111114141111114114444444444444444411111111111111111111
111111111111111111110000000010000000011011011101011101101100000000000000000110110101111101011011000010001000100001111101110101110111100010100030001010001111010116110101111000000013731000000011110101111101011110001010000000101000111101011111010111110000000010000000011011111101011111101100010000200001000111101010111010101111000001001001000001101111110101111110110000004444000000011111111111111111111